1, 1, 1, 1, 1, 1, 1, 1, 1, 1
1, 1, 1, 1, 1, 1, 1, 1, 1, 1
1, 1, 1, 1, 1, 1, 1, 1, 1, 1
1, 0, 0, 4, 3, 0, 1, 1, 1, 1
1, 0, 4, 3, 4, 3, 0, 0, 1, 1
1, 7, 3, 4, 3, 4, 2, 0, 1, 1
1, 0, 4, 3, 4, 3, 0, 1, 1, 1
1, 0, 0, 4, 3, 0, 0, 1, 1, 1
1, 1, 1, 1, 1, 1, 1, 1, 1, 1
1, 1, 1, 1, 1, 1, 1, 1, 1, 1